META =
{
    NAME   = "ROOM 1";
    SIZE   = 64;
    WIDTH  = 20;
    HEIGHT = 11;
}

DATA =
{
    0 0 0 0 0 0 0 0 0 0 0 0 0 0 0 0 0 0 0 0
    0 1 1 1 1 1 1 1 1 1 1 1 1 1 1 1 1 1 1 0
    0 1 1 1 1 1 1 1 1 1 1 1 1 1 1 1 1 1 1 0
    0 1 1 1 1 1 1 1 1 1 1 1 1 1 1 1 1 1 1 0
    0 1 1 1 1 1 1 1 1 1 1 1 1 1 1 1 1 1 1 0
    0 0 0 0 0 1 1 1 1 1 1 1 0 0 1 1 1 1 1 0
    0 1 1 1 1 1 1 1 1 1 1 1 1 1 1 1 1 1 1 0
    1 1 1 1 1 1 1 1 1 1 1 1 1 1 1 1 1 1 1 1
    1 1 1 1 1 1 1 1 1 1 1 1 1 1 1 1 1 1 1 1
    1 1 1 1 1 1 1 1 1 1 1 1 1 1 1 1 1 1 1 1
    0 0 0 0 0 0 0 0 0 0 0 1 1 0 0 0 0 0 0 0
}

PHYSIC =
{
    GRAVITY = -9.81;

    { 0,  0, H, 20, 1},
    { 0,  1, V,  6, 1},
    { 0, 10, H, 11, 1},
    {13, 10, H,  7, 1},
    {19,  1, V,  6, 1},
    { 1,  5, H,  4, 1},
    {12,  5, H,  2, 1};
}