META =
{
    NAME   = "ROOM 1";
    SIZE   = 64;
    WIDTH  = 20;
    HEIGHT = 11;
}

DATA =
{
    LAYER =
    {
        ID = 1;
        DATA = {
            1 1 1 1 1 1 1 1 1 1 1 1 1 1 1 1 1 1 1 1
            1 0 0 0 0 0 0 0 0 0 0 0 0 0 0 0 0 0 0 1
            1 0 0 0 0 0 0 0 0 0 0 0 0 0 0 0 0 0 0 1
            1 0 0 0 0 0 0 0 0 0 0 0 0 0 0 0 0 0 0 1
            1 0 0 0 0 0 0 0 0 0 0 0 0 0 0 0 0 0 0 1
            1 2 2 2 2 0 0 0 0 0 0 0 2 2 0 0 0 0 0 1
            1 0 0 0 0 0 0 0 0 0 0 0 0 0 0 0 0 0 0 1
            0 0 0 0 0 0 0 0 0 0 0 0 0 0 0 0 0 0 0 0
            0 0 0 0 0 0 0 0 0 0 0 0 0 0 0 0 0 0 0 0
            0 0 0 0 0 0 0 0 0 0 0 0 0 0 0 0 0 0 0 0
            1 1 1 1 1 1 1 1 1 1 1 0 0 1 1 1 1 1 1 1
        };
    }

    LAYER =
    {
        ID = 2;
        DATA = {
            1 1 1 1 1 1 1 1 1 1 1 1 1 1 1 1 1 1 1 1
            1 0 0 0 0 0 0 0 0 0 0 0 0 0 0 0 0 0 0 1
            1 0 0 0 0 0 0 0 0 0 0 0 0 0 0 0 0 0 0 1
            1 0 0 0 0 0 0 0 0 0 0 0 0 0 0 0 0 0 0 1
            1 0 0 0 0 0 0 0 0 0 0 0 0 0 0 0 0 0 0 1
            1 1 1 1 1 0 0 0 0 0 0 0 1 1 0 0 0 0 0 1
            1 0 0 0 0 0 0 0 0 0 0 0 0 0 0 0 0 0 0 1
            0 0 0 0 0 0 0 0 0 0 0 0 0 0 0 0 0 0 0 0
            0 0 0 0 0 0 0 0 0 0 0 0 0 0 0 0 0 0 0 0
            0 0 0 0 0 0 0 0 0 0 0 0 0 0 0 0 0 0 0 0
            1 1 1 1 1 1 1 1 1 1 1 0 0 1 1 1 1 1 1 1
        };
    }
}

PHYSIC =
{
    GRAVITY = -9.81;
    COLLIDER =
    {
        { 0,  0, 20, 1}
        { 0,  1,  1, 6}
        { 0, 10, 11, 1}
        {13, 10,  7, 1}
        {19,  1,  1, 6}
        { 1,  5,  4, 1}
        {12,  5,  2, 1}
    };
}