META =
{
    NAME   = "ROOM 1";
    SIZE   = 64;
    WIDTH  = 20;
    HEIGHT = 11;
}

DATA =
{
    0 0 0 0 0 0 0 0 0 0 0 0 0 0 0 0 0 0 0 0
    0 1 1 1 1 1 1 1 1 1 1 1 1 1 1 1 1 1 1 0
    0 1 1 1 1 1 1 1 1 1 1 1 1 1 1 1 1 1 1 0
    0 1 1 1 1 1 1 1 1 1 1 1 1 1 1 1 1 1 1 0
    0 1 1 1 1 1 1 1 1 1 1 1 1 1 1 1 1 1 1 0
    0 0 0 0 0 1 1 1 1 1 1 1 0 0 1 1 1 1 1 0
    0 1 1 1 1 1 1 1 1 1 1 1 1 1 1 1 1 1 1 0
    1 1 1 1 1 1 1 1 1 1 1 1 1 1 1 1 1 1 1 1
    1 1 1 1 1 1 1 1 1 1 1 1 1 1 1 1 1 1 1 1
    1 1 1 1 1 1 1 1 1 1 1 1 1 1 1 1 1 1 1 1
    0 0 0 0 0 0 0 0 0 0 0 1 1 0 0 0 0 0 0 0
}

PHYSIC =
{
    GRAVITY = -9.81;

    { 0,  0, 20, 1},
    { 0,  1,  1, 6},
    { 0, 10, 11, 1},
    {13, 10,  7, 1},
    {19,  1,  1, 6},
    { 1,  5,  4, 1},
    {12,  5,  2, 1};
}