META =
{
    NAME   = ROOM_3
    SIZE   = 64
    WIDTH  = 20
    HEIGHT = 12
}

DATA =
{

# MAXI 4 LAYER !!
    LAYER =
    {
        DATA =
        {
            1 1 1 1 1 1 1 1 1 1 1 1 1 1 1 1 1 1 1 1
            1 0 0 0 0 0 0 0 0 0 0 0 0 0 0 0 0 0 0 1
            1 0 0 0 0 0 0 0 0 0 0 0 0 0 0 0 0 0 0 1
            1 0 0 0 0 0 0 0 0 0 0 0 0 0 0 0 0 0 0 1
            1 0 0 0 0 0 0 0 0 0 0 0 0 0 0 0 0 0 0 1
            1 1 1 1 0 0 0 0 0 0 0 0 0 0 0 0 0 0 0 1
            1 0 0 0 0 0 0 0 0 0 0 0 0 0 0 0 0 0 0 1
            1 0 0 0 0 0 0 0 0 0 0 0 0 0 0 0 0 0 0 1
            0 0 0 0 0 0 1 1 1 0 0 1 1 0 0 0 0 0 0 0
            0 0 0 0 0 1 1 1 1 0 0 1 1 1 0 0 0 0 0 0
            0 0 0 0 1 1 1 1 1 0 0 1 1 1 1 0 0 0 0 0
            1 1 1 1 1 1 1 1 1 0 0 1 1 1 1 1 1 1 1 1
        }
    }

    LAYER =
    {
        DATA =
        {
            0 0 0 0 0 0 0 0 0 0 0 0 0 0 0 0 0 0 0 0
            0 0 0 0 0 0 0 0 0 0 0 0 0 0 0 0 0 0 0 0
            0 0 0 0 0 0 0 0 0 0 0 0 0 0 0 0 0 0 0 0
            0 0 0 0 0 0 0 0 0 0 0 0 0 0 0 0 0 0 0 0
            0 0 0 0 0 0 0 0 0 0 0 0 0 0 0 0 0 0 0 0
            0 0 0 0 0 0 0 0 0 0 0 0 0 0 0 0 0 0 0 0
            0 0 0 0 0 0 0 0 0 0 0 0 0 0 0 0 0 0 0 0
            0 0 0 0 0 0 0 0 0 0 0 0 0 0 0 0 0 0 0 0
            0 0 0 0 0 0 0 0 0 0 0 0 0 0 0 0 0 0 0 0
            0 0 0 0 0 0 0 0 0 0 0 0 0 0 0 0 0 0 0 0
            0 0 0 0 0 0 0 0 0 0 0 0 0 0 0 0 0 0 0 0
            0 0 0 0 0 0 0 0 0 0 0 0 0 0 0 0 0 0 0 0
        }
    }
}

PHYSIC =
{
    COLLIDER =
    {
        #[ 0   0   20  1 ]
        [ 0   1   1   7 ]
        [ 0   11  9   1 ]
        [ 11  11  9   1 ]
        [ 19  1   1   7 ]
        [ 1   5   3   1 ]
        [ 4   10  5   1 ]
        [ 5   9   4   1 ]
        [ 6   8   3   1 ]
        [ 11  10  4   1 ]
        [ 11  9   3   1 ]
        [ 11  8   2   1 ]
    }
}