META =
{
    NAME   = ROOM_2
    SIZE   = 64
    WIDTH  = 20
    HEIGHT = 12
}

DATA =
{

# MAXI 4 LAYER !!
    LAYER =
    {
        DATA =
        {
            1 1 1 1 1 1 1 1 1 1 1 1 1 1 1 1 1 1 1 1
            1 0 0 0 0 0 0 0 0 0 0 0 0 0 0 0 0 0 0 1
            1 0 0 0 0 0 0 0 0 0 0 0 0 0 0 0 0 0 0 1
            1 0 0 0 0 0 0 0 0 0 0 0 0 0 0 0 0 0 0 1
            1 0 0 0 0 0 0 0 0 0 0 0 0 0 0 0 0 0 0 1
            1 1 1 1 1 0 0 0 0 0 0 0 1 1 0 0 0 0 0 1
            1 0 0 0 0 0 0 0 0 0 0 0 0 0 0 0 0 0 0 1
            1 0 0 0 0 0 0 0 0 0 0 0 0 0 0 0 0 0 0 1
            0 0 0 0 0 0 0 0 0 0 0 0 0 0 0 0 0 0 0 0
            0 0 0 0 0 0 0 0 0 0 0 0 0 0 0 0 0 0 0 0
            0 0 0 0 0 0 0 0 0 0 0 0 0 0 0 0 0 0 0 0
            1 1 1 1 1 1 1 1 1 1 1 0 0 1 1 1 1 1 1 1
        }
    }

    LAYER =
    {
        DATA =
        {
           0 0 0 0 0 0 0 0 0 0 0 0 0 0 0 0 0 0 0 0
           0 0 0 0 0 0 0 0 0 0 0 0 0 0 0 0 0 0 0 0
           0 0 0 0 0 0 0 0 0 0 0 0 0 0 0 0 0 0 0 0
           0 0 0 0 0 0 0 0 0 0 0 0 0 0 0 0 0 0 0 0
           0 0 0 0 0 0 0 0 0 0 0 0 0 0 0 0 0 0 0 0
           0 0 0 0 0 0 0 0 0 0 0 0 0 0 0 0 0 0 0 0
           0 0 0 0 0 0 0 0 0 0 0 0 0 0 0 0 0 0 0 0
           0 0 0 0 0 0 0 0 0 0 0 0 0 0 0 0 0 0 0 0
           0 0 0 0 0 0 0 0 0 0 0 0 0 0 0 0 0 0 0 0
           0 0 0 0 0 0 0 0 0 0 0 0 0 0 0 0 0 0 0 0
           0 0 0 0 0 0 0 0 0 0 0 0 0 0 0 0 0 0 0 0
           0 0 0 0 0 0 0 0 0 0 0 0 0 0 0 0 0 0 0 0
        }
    }
}

PHYSIC =
{
    COLLIDER =
    {
        [ 0   0   20  1 ]
        [ 0   1   1   7 ]
        [ 0   11  11  1 ]
        [ 19  1   1   7 ]
        [ 13  11  7   1 ]
        [ 1   5   4   1 ]
        [ 12  5   2   1 ]
    }
}