META =
{
    NAME   = ROOM_1
    SIZE   = 64
    WIDTH  = 20
    HEIGHT = 12
}

DATA =
{
    LAYER =
    {
        DATA =
        {
            1 1 1 1 1 1 1 1 1 1 1 1 1 1 1 1 1 1 1 1
            1 0 0 0 0 0 0 0 0 0 0 0 0 0 0 0 0 0 0 1
            1 0 0 0 0 0 0 0 0 0 0 0 0 0 0 0 0 0 0 1
            1 0 0 0 0 0 0 0 0 0 0 0 0 0 0 0 0 0 0 1
            1 0 0 0 0 0 0 0 0 0 0 0 0 0 0 0 0 0 0 1
            1 0 0 0 0 0 0 1 1 1 0 0 0 0 0 0 0 0 0 1
            1 0 0 0 0 0 0 0 0 0 0 0 0 0 0 0 0 0 0 1
            1 1 1 1 0 0 0 0 0 0 0 1 1 1 1 1 1 0 0 1
            0 0 0 0 0 0 0 0 0 0 0 0 0 0 0 0 0 0 0 0
            0 0 0 0 0 0 0 0 0 0 0 0 0 0 0 0 0 0 0 0
            0 0 0 0 0 0 0 0 0 0 0 0 0 0 0 0 0 0 0 0
            1 1 1 1 1 1 1 1 1 1 1 1 1 1 1 1 1 1 1 1
        }
    }

    LAYER =
    {
        DATA =
        {
            0 0 0 0 0 0 0 0 0 0 0 0 0 0 0 0 0 0 0 0
            0 0 0 0 0 0 0 0 0 0 0 0 0 0 0 0 0 0 0 0
            0 0 0 0 0 0 0 0 0 0 0 0 0 0 0 0 0 0 0 0
            0 0 0 0 0 0 0 0 0 0 0 0 0 0 0 0 0 0 0 0
            0 0 0 0 0 0 0 0 0 0 0 0 0 0 0 0 0 0 0 0
            0 0 0 0 0 0 0 0 0 0 0 0 0 0 0 0 0 0 0 0
            0 0 0 0 0 0 0 0 0 0 0 0 0 0 0 0 0 0 0 0
            0 0 0 0 0 0 0 0 0 0 0 0 0 0 0 0 0 0 0 0
            0 0 0 0 0 0 0 0 0 0 0 0 0 0 0 0 0 0 0 0
            0 0 0 0 0 0 0 0 0 0 0 0 0 0 0 0 0 0 0 0
            0 0 0 0 0 0 0 0 0 0 0 0 0 0 0 0 0 0 0 0
            0 0 0 0 0 0 0 0 0 0 0 0 0 0 0 0 0 0 0 0
        }
    }
}

PHYSIC =
{
    COLLIDER =
    {
        #[ 0   0   20  1 ]
        [ 0   1   1   7 ]
        [ 0   11  20  1 ]
        [ 1   7   3   1 ]
        [ 7   5   3   1 ]
        [ 11  7   6   1 ]
        [ 19  11  1   7 ]
    }
}