META =
{
    NAME   = ROOM_4
    SIZE   = 64
    WIDTH  = 20
    HEIGHT = 12
}

DATA =
{

# MAXI 4 LAYER !!
    LAYER =
    {
        DATA =
        {
            1 1 1 1 1 1 1 1 1 1 1 1 1 1 1 1 1 1 1 1
            1 0 0 0 0 0 0 0 0 0 0 0 0 0 0 0 0 0 0 1
            1 0 0 0 0 0 0 0 0 0 0 0 0 0 0 0 0 0 0 1
            1 0 0 0 1 1 1 1 0 0 1 1 1 1 1 0 0 1 1 1
            1 1 0 0 0 0 0 0 0 0 1 0 0 0 0 0 0 0 0 1
            1 1 1 0 0 0 0 0 0 0 1 0 0 0 0 0 0 0 0 1
            1 1 1 1 0 0 0 0 0 0 0 0 0 0 0 0 0 0 0 1
            1 1 1 1 1 0 0 1 1 0 0 0 0 0 0 0 0 0 0 1
            0 0 0 0 0 0 0 0 0 0 0 0 1 1 0 0 0 0 0 0
            0 0 0 0 0 0 0 0 0 0 0 1 1 0 0 0 0 0 0 0
            0 0 0 0 0 0 0 0 0 0 1 1 1 0 0 0 0 0 0 0
            1 1 1 1 1 1 1 1 1 0 1 1 1 1 1 1 1 1 1 1
        }
    }

    LAYER =
    {
        DATA =
        {
            0 0 0 0 0 0 0 0 0 0 0 0 0 0 0 0 0 0 0 0
            0 0 0 0 0 0 0 0 0 0 0 0 0 0 0 0 0 0 0 0
            0 0 0 0 0 0 0 0 0 0 0 0 0 0 0 0 0 0 0 0
            0 0 0 0 0 0 0 0 0 0 0 0 0 0 0 0 0 0 0 0
            0 0 0 0 0 0 0 0 0 0 0 0 0 0 0 0 0 0 0 0
            0 0 0 0 0 0 0 0 0 0 0 0 0 0 0 0 0 0 0 0
            0 0 0 0 0 0 0 0 0 0 0 0 0 0 0 0 0 0 0 0
            0 0 0 0 0 0 0 0 0 0 0 0 0 0 0 0 0 0 0 0
            0 0 0 0 0 0 0 0 0 0 0 0 0 0 0 0 0 0 0 0
            0 0 0 0 0 0 0 0 0 0 0 0 0 0 0 0 0 0 0 0
            0 0 0 0 0 0 0 0 0 0 0 0 0 0 0 0 0 0 0 0
            0 0 0 0 0 0 0 0 0 0 0 0 0 0 0 0 0 0 0 0
        }
    }
}

PHYSIC =
{
    COLLIDER =
    {
        [ 0   0   20  1 ]
        [ 0   1   1   7 ]
        [ 0   9   11  1 ]
        [ 11  11  10  1 ]
        [ 19  1   1   7 ]
        [ 10  10  3   1 ]
        [ 11  9   2   1 ]
        [ 12  8   2   1 ]
        [ 4   3   4   1 ]
        [ 1   5   1   1 ]
        [ 1   6   2   1 ]
        [ 1   7   3   1 ]
        [ 1   8   4   1 ]
        [ 7   8   2   1 ]
        [ 10  3   5   1 ]
        [ 10  4   1   2 ]
        [ 17  3   2   1 ]
    }
}